###########################
#S          #             #
# ### # ### # ### ####### #
# # # # # # # #   #       #
# # # ### # # # ### ### # #
#   #       # # #   #   # #
# ######### # ### ####### #
#     #         #         #
##### # ####### ###########
#     # #     #           #
# ##### ### # #############
# # #       #             #
# # ####### # ########### #
#           # # #       # #
########### # # # ##### # #
#           # # #     # # #
# ############# ##### # # #
# #   #   #   #       # # #
# # # # # # # ######### # #
#   #   #   #           #F#
###########################