###########################
#S          #             #
# ### # ### # ### ####### #
# # # # # # # #   #       #
# # # ### # # # ### ### # #
#   #       # # #   #   # #
# ######### # ### ####### #
#         #   # #         #
##### ### # ### ###########
#     ### # # #           #
# ### ### # # ########### #
# # #     # #             #
### ####### # # ######### #
#           # # #       # #
# ######### # # # ##### # #
# #         # # #     # # #
# ############# ##### # # #
# #   #   #   #       # # #
# # # # # # # ######### # #
#   #   #   #           #F#
###########################